****@***************
****@***************
****@***************
****@***************
****@#**************
****@#**************
**##@***************
**##@***######******
****@***@@@@@@******
****@#*#@****@#*****
****@#*#@#**#@******
****@#*#@****@******
****@###@**##@##****
****@###@**##@##****
****@@@@@****@******
****#***#*###@###***
**********###@###***
**********###@###***
**********###@###***
*************^******